B951555553
C6FAFBFFFA
93FEF857FA
AAFFFAFFFA
A83BFAFD52
EA86FAFFFA
96E9541796
C55457C547

0,0
9,7
SENEEEEEEEESSSSSSWSE
